ID_FACTURA_DETALLE,ID_FACTURA_CABECERA,ID_FORMACION,PRECIO,MONTO_DESCUENTO,SUBTOTAL
1,1,67,554889,83233,471656
2,1,64,735783,147157,588626
3,2,49,292071,29207,262864
4,3,79,686677,103002,583675
5,3,40,140454,21068,119386
6,4,17,939423,93942,845481
7,5,87,434054,86811,347243
8,6,85,896270,44814,851456
9,6,10,926002,0,926002
10,7,16,620111,31006,589105
11,7,23,634305,95146,539159
12,7,93,186842,9342,177500
13,8,55,683200,68320,614880
14,8,56,765100,76510,688590
15,9,76,252436,37865,214571
16,9,97,979782,195956,783826
17,9,57,922013,92201,829812
18,10,48,642399,64240,578159
19,10,62,905813,135872,769941
20,11,87,434054,65108,368946
21,12,12,295990,29599,266391
22,12,80,728935,72894,656041
23,13,99,398614,59792,338822
24,14,28,144785,0,144785
25,15,18,381216,0,381216
26,15,97,979782,195956,783826
27,16,81,924381,138657,785724
28,16,70,164588,8229,156359
29,17,82,316592,0,316592
30,17,71,510460,0,510460
31,17,25,702215,70222,631993
32,18,30,731284,0,731284
33,19,53,820943,123141,697802
34,19,21,323151,0,323151
35,20,6,406435,40644,365791
36,20,25,702215,105332,596883
37,21,52,587764,88165,499599
38,22,46,693176,138635,554541
39,23,68,654889,98233,556656
40,24,75,620666,93100,527566
41,25,4,798907,79891,719016
42,26,52,587764,88165,499599
43,27,66,454889,45489,409400
44,28,2,420981,0,420981
45,28,85,896270,89627,806643
46,29,55,683200,68320,614880
47,30,66,454889,0,454889
48,30,86,684158,68416,615742
49,30,54,589480,0,589480
50,31,68,654889,98233,556656
51,31,44,522577,0,522577
52,32,47,226500,11325,215175
53,32,49,292071,0,292071
54,33,32,654698,130940,523758
55,34,36,428476,21424,407052
56,35,24,768119,115218,652901
57,36,83,628744,31437,597307
58,37,97,979782,97978,881804
59,38,29,341390,34139,307251
60,39,9,455685,68353,387332
61,39,18,381216,76243,304973
62,40,57,922013,46101,875912
63,41,40,140454,0,140454
64,42,23,634305,0,634305
65,43,3,732156,146431,585725
66,44,5,269564,40435,229129
67,45,5,269564,13478,256086
68,46,32,654698,98205,556493
69,46,37,604367,90655,513712
70,47,79,686677,103002,583675
71,47,7,314151,0,314151
72,48,78,351139,70228,280911
73,48,60,970703,194141,776562
74,49,33,737686,36884,700802
75,50,92,776090,155218,620872
76,51,66,454889,0,454889
77,52,13,463695,0,463695
78,52,22,170261,0,170261
79,53,99,398614,39861,358753
80,54,3,732156,0,732156
81,54,9,455685,68353,387332
82,55,75,620666,31033,589633
83,55,64,735783,0,735783
84,56,68,654889,130978,523911
85,57,19,804753,160951,643802
86,57,52,587764,29388,558376
87,57,21,323151,32315,290836
88,58,5,269564,40435,229129
89,59,72,368254,55238,313016
90,59,58,192637,28896,163741
91,60,72,368254,18413,349841
92,60,49,292071,0,292071
93,60,28,144785,21718,123067
94,61,50,729367,109405,619962
95,61,77,779556,116933,662623
96,62,92,776090,155218,620872
97,63,21,323151,0,323151
98,64,55,683200,102480,580720
99,65,78,351139,35114,316025
100,66,37,604367,0,604367
101,66,53,820943,0,820943
102,66,22,170261,25539,144722
103,67,15,902160,180432,721728
104,68,83,628744,62874,565870
105,69,89,279537,0,279537
106,70,30,731284,36564,694720
107,70,91,601955,120391,481564
108,70,57,922013,138302,783711
109,71,62,905813,181163,724650
110,71,42,857814,0,857814
111,72,71,510460,25523,484937
112,73,20,869016,0,869016
113,74,31,104484,0,104484
114,74,28,144785,28957,115828
115,75,48,642399,32120,610279
116,76,92,776090,155218,620872
117,76,74,844993,0,844993
118,77,46,693176,69318,623858
119,78,89,279537,27954,251583
120,79,29,341390,51208,290182
121,80,74,844993,126749,718244
122,80,92,776090,77609,698481
123,81,4,798907,119836,679071
124,82,70,164588,32918,131670
125,82,48,642399,32120,610279
126,82,89,279537,13977,265560
127,83,22,170261,25539,144722
128,83,53,820943,0,820943
129,84,55,683200,68320,614880
130,84,63,825937,0,825937
131,85,100,675789,67579,608210
132,86,76,252436,50487,201949
133,86,66,454889,22744,432145
134,87,77,779556,155911,623645
135,87,90,398303,0,398303
136,88,99,398614,59792,338822
137,88,65,950505,95050,855455
138,89,42,857814,85781,772033
139,89,70,164588,0,164588
140,90,68,654889,0,654889
141,90,34,327720,49158,278562
142,91,36,428476,21424,407052
143,91,22,170261,8513,161748
144,92,62,905813,181163,724650
145,93,84,150772,15077,135695
146,94,15,902160,90216,811944
147,95,44,522577,26129,496448
148,96,36,428476,85695,342781
149,96,90,398303,39830,358473
150,97,66,454889,90978,363911
151,97,67,554889,27744,527145
152,98,7,314151,47123,267028
153,98,77,779556,116933,662623
154,99,48,642399,128480,513919
155,100,44,522577,52258,470319
156,101,92,776090,38804,737286
157,102,12,295990,29599,266391
158,103,38,914051,45703,868348
159,104,92,776090,38804,737286
160,105,80,728935,36447,692488
161,106,19,804753,80475,724278
162,107,3,732156,109823,622333
163,107,96,438412,43841,394571
164,108,10,926002,0,926002
165,108,47,226500,22650,203850
166,108,53,820943,123141,697802
167,109,78,351139,0,351139
168,110,32,654698,65470,589228
169,111,75,620666,62067,558599
170,111,82,316592,63318,253274
171,111,73,868669,130300,738369
172,112,80,728935,36447,692488
173,113,20,869016,0,869016
174,114,82,316592,31659,284933
175,114,54,589480,0,589480
176,114,7,314151,62830,251321
177,115,84,150772,22616,128156
178,116,53,820943,82094,738849
179,117,59,605860,121172,484688
180,118,91,601955,0,601955
181,119,49,292071,29207,262864
182,120,42,857814,85781,772033
183,121,56,765100,153020,612080
184,122,7,314151,62830,251321
185,123,25,702215,0,702215
186,124,83,628744,31437,597307
187,125,57,922013,0,922013
188,125,100,675789,135158,540631
189,126,61,151169,22675,128494
190,127,81,924381,138657,785724
191,127,91,601955,60196,541759
192,128,19,804753,160951,643802
193,129,19,804753,120713,684040
194,130,68,654889,0,654889
195,130,14,857700,171540,686160
196,131,50,729367,145873,583494
197,132,25,702215,35111,667104
198,133,100,675789,0,675789
199,133,36,428476,0,428476
200,134,16,620111,31006,589105
201,134,5,269564,53913,215651
202,135,68,654889,98233,556656
203,135,98,402922,60438,342484
204,136,42,857814,171563,686251
205,136,38,914051,137108,776943
206,137,29,341390,17070,324320
207,137,68,654889,130978,523911
208,137,100,675789,135158,540631
209,138,89,279537,13977,265560
210,139,19,804753,80475,724278
211,139,11,200350,0,200350
212,139,73,868669,130300,738369
213,140,84,150772,0,150772
214,140,95,149157,22374,126783
215,141,8,874637,87464,787173
216,141,35,586266,0,586266
217,141,80,728935,36447,692488
218,142,24,768119,0,768119
219,143,12,295990,0,295990
220,143,9,455685,22784,432901
221,144,31,104484,20897,83587
222,145,86,684158,102624,581534
223,146,2,420981,21049,399932
224,147,44,522577,104515,418062
225,147,58,192637,19264,173373
226,148,8,874637,0,874637
227,149,94,708466,35423,673043
228,149,27,514662,25733,488929
229,150,4,798907,0,798907
230,151,79,686677,0,686677
231,152,27,514662,77199,437463
232,153,20,869016,0,869016
233,153,95,149157,22374,126783
234,154,17,939423,187885,751538
235,155,72,368254,73651,294603
236,156,59,605860,30293,575567
237,157,89,279537,0,279537
238,158,48,642399,32120,610279
239,159,40,140454,7023,133431
240,160,53,820943,82094,738849
241,161,32,654698,98205,556493
242,162,7,314151,47123,267028
243,163,99,398614,0,398614
244,164,62,905813,181163,724650
245,165,88,654347,0,654347
246,165,30,731284,36564,694720
247,166,69,359892,53984,305908
248,167,98,402922,80584,322338
249,168,96,438412,21921,416491
250,169,59,605860,90879,514981
251,170,75,620666,124133,496533
252,171,96,438412,65762,372650
253,171,27,514662,25733,488929
254,172,4,798907,79891,719016
255,173,51,493814,49381,444433
256,173,19,804753,160951,643802
257,173,18,381216,57182,324034
258,174,73,868669,0,868669
259,174,3,732156,0,732156
260,175,37,604367,30218,574149
261,175,70,164588,8229,156359
262,176,26,385971,38597,347374
263,177,70,164588,8229,156359
264,178,13,463695,69554,394141
265,179,60,970703,97070,873633
266,180,83,628744,94312,534432
267,181,84,150772,0,150772
268,181,6,406435,60965,345470
269,181,13,463695,0,463695
270,182,78,351139,70228,280911
271,182,47,226500,11325,215175
272,183,43,763211,114482,648729
273,184,35,586266,58627,527639
274,185,50,729367,109405,619962
275,186,67,554889,55489,499400
276,187,8,874637,87464,787173
277,188,90,398303,39830,358473
278,188,1,256100,38415,217685
279,188,91,601955,30098,571857
280,189,78,351139,70228,280911
281,190,14,857700,171540,686160
282,190,89,279537,55907,223630
283,190,55,683200,68320,614880
284,191,16,620111,0,620111
285,192,23,634305,63430,570875
286,193,73,868669,43433,825236
287,194,25,702215,70222,631993
288,194,50,729367,0,729367
289,195,71,510460,0,510460
290,195,3,732156,0,732156
291,196,99,398614,39861,358753
292,197,56,765100,153020,612080
293,197,18,381216,0,381216
294,197,16,620111,124022,496089
295,198,49,292071,58414,233657
296,198,73,868669,130300,738369
297,198,2,420981,42098,378883
298,199,70,164588,32918,131670
299,200,13,463695,23185,440510
300,201,61,151169,30234,120935
301,202,74,844993,168999,675994
302,202,30,731284,36564,694720
303,203,82,316592,63318,253274
304,203,26,385971,0,385971
305,204,7,314151,62830,251321
306,205,58,192637,9632,183005
307,205,15,902160,90216,811944
308,206,13,463695,92739,370956
309,207,23,634305,95146,539159
310,207,46,693176,103976,589200
311,208,16,620111,124022,496089
312,208,69,359892,71978,287914
313,209,6,406435,81287,325148
314,210,24,768119,153624,614495
315,211,44,522577,52258,470319
316,211,39,281587,56317,225270
317,212,60,970703,48535,922168
318,213,51,493814,98763,395051
319,214,53,820943,41047,779896
320,215,46,693176,0,693176
321,216,83,628744,125749,502995
322,217,46,693176,0,693176
323,218,26,385971,19299,366672
324,218,43,763211,76321,686890
325,218,27,514662,25733,488929
326,219,74,844993,42250,802743
327,220,5,269564,13478,256086
328,221,80,728935,36447,692488
329,221,28,144785,14478,130307
330,222,60,970703,194141,776562
331,222,38,914051,137108,776943
332,223,15,902160,135324,766836
333,223,18,381216,57182,324034
334,224,82,316592,31659,284933
335,225,48,642399,64240,578159
336,225,7,314151,0,314151
337,225,89,279537,27954,251583
338,226,73,868669,130300,738369
339,227,43,763211,152642,610569
340,228,89,279537,27954,251583
341,229,34,327720,65544,262176
342,229,28,144785,14478,130307
343,230,33,737686,147537,590149
344,230,93,186842,18684,168158
345,231,84,150772,30154,120618
346,232,41,673087,0,673087
347,232,71,510460,76569,433891
348,233,77,779556,116933,662623
349,233,28,144785,21718,123067
350,234,69,359892,53984,305908
351,235,18,381216,76243,304973
352,236,99,398614,39861,358753
353,236,58,192637,9632,183005
354,237,89,279537,41931,237606
355,238,56,765100,114765,650335
356,239,4,798907,79891,719016
357,240,81,924381,46219,878162
358,241,3,732156,0,732156
359,242,85,896270,0,896270
360,243,69,359892,71978,287914
361,243,40,140454,0,140454
362,244,61,151169,22675,128494
363,245,11,200350,40070,160280
364,246,95,149157,29831,119326
365,247,21,323151,16158,306993
366,248,38,914051,0,914051
367,248,25,702215,105332,596883
368,249,11,200350,10018,190332
369,250,55,683200,136640,546560
370,250,65,950505,0,950505
371,250,16,620111,31006,589105
372,251,60,970703,97070,873633
373,252,16,620111,62011,558100
374,253,56,765100,153020,612080
375,254,71,510460,0,510460
376,255,41,673087,33654,639433
377,256,15,902160,45108,857052
378,256,76,252436,25244,227192
379,257,23,634305,31715,602590
380,258,38,914051,91405,822646
381,259,97,979782,97978,881804
382,260,57,922013,92201,829812
383,260,8,874637,174927,699710
384,261,78,351139,0,351139
385,262,37,604367,0,604367
386,263,7,314151,0,314151
387,264,60,970703,48535,922168
388,265,93,186842,37368,149474
389,265,11,200350,10018,190332
390,265,89,279537,0,279537
391,266,84,150772,30154,120618
392,267,67,554889,55489,499400
393,268,56,765100,0,765100
394,269,65,950505,47525,902980
395,269,61,151169,30234,120935
396,270,12,295990,59198,236792
397,270,79,686677,34334,652343
398,271,64,735783,36789,698994
399,271,29,341390,68278,273112
400,271,97,979782,195956,783826
401,272,82,316592,0,316592
402,272,84,150772,22616,128156
403,272,73,868669,173734,694935
404,273,86,684158,0,684158
405,274,13,463695,23185,440510
406,275,40,140454,7023,133431
407,276,88,654347,0,654347
408,277,75,620666,31033,589633
409,277,78,351139,52671,298468
410,278,7,314151,62830,251321
411,278,1,256100,51220,204880
412,278,96,438412,43841,394571
413,279,20,869016,43451,825565
414,280,33,737686,110653,627033
415,280,12,295990,29599,266391
416,280,25,702215,70222,631993
417,281,54,589480,29474,560006
418,281,38,914051,137108,776943
419,282,99,398614,79723,318891
420,283,10,926002,46300,879702
421,283,53,820943,41047,779896
422,283,62,905813,45291,860522
423,284,15,902160,90216,811944
424,284,91,601955,120391,481564
425,285,63,825937,82594,743343
426,286,31,104484,0,104484
427,287,25,702215,35111,667104
428,287,45,425902,63885,362017
429,287,23,634305,31715,602590
430,288,59,605860,0,605860
431,289,14,857700,171540,686160
432,290,40,140454,28091,112363
433,291,6,406435,0,406435
434,292,60,970703,194141,776562
435,293,40,140454,28091,112363
436,293,68,654889,98233,556656
437,293,52,587764,29388,558376
438,294,77,779556,155911,623645
439,294,30,731284,36564,694720
440,295,24,768119,0,768119
441,296,6,406435,0,406435
442,297,59,605860,30293,575567
443,297,72,368254,55238,313016
444,298,63,825937,41297,784640
445,298,54,589480,0,589480
446,298,78,351139,35114,316025
447,299,42,857814,85781,772033
448,300,29,341390,51208,290182
449,301,8,874637,131196,743441
450,301,71,510460,25523,484937
451,301,34,327720,65544,262176
452,302,93,186842,28026,158816
453,303,25,702215,35111,667104
454,304,58,192637,28896,163741
455,304,73,868669,173734,694935
456,305,58,192637,9632,183005
457,306,24,768119,76812,691307
458,307,64,735783,110367,625416
459,307,98,402922,60438,342484
460,308,92,776090,0,776090
461,308,44,522577,104515,418062
462,308,77,779556,0,779556
463,309,52,587764,117553,470211
464,310,59,605860,90879,514981
465,310,96,438412,0,438412
466,311,100,675789,0,675789
467,312,22,170261,25539,144722
468,313,33,737686,36884,700802
469,314,31,104484,20897,83587
470,314,13,463695,0,463695
471,314,14,857700,128655,729045
472,315,61,151169,15117,136052
473,316,46,693176,69318,623858
474,317,65,950505,47525,902980
475,318,96,438412,87682,350730
476,319,51,493814,24691,469123
477,320,72,368254,36825,331429
478,321,30,731284,36564,694720
479,321,23,634305,95146,539159
480,321,15,902160,135324,766836
481,322,54,589480,117896,471584
482,323,29,341390,68278,273112
483,324,47,226500,22650,203850
484,324,87,434054,21703,412351
485,324,32,654698,32735,621963
486,325,42,857814,0,857814
487,326,2,420981,21049,399932
488,326,6,406435,60965,345470
489,327,24,768119,115218,652901
490,328,39,281587,0,281587
491,328,82,316592,31659,284933
492,329,80,728935,72894,656041
493,330,76,252436,50487,201949
494,331,80,728935,0,728935
495,332,11,200350,30052,170298
496,332,30,731284,109693,621591
497,332,96,438412,65762,372650
498,333,73,868669,130300,738369
499,334,21,323151,0,323151
500,335,14,857700,42885,814815
501,336,13,463695,0,463695
502,336,64,735783,36789,698994
503,337,29,341390,34139,307251
504,338,73,868669,173734,694935
505,339,36,428476,0,428476
506,339,32,654698,65470,589228
507,340,75,620666,62067,558599
508,341,75,620666,93100,527566
509,341,3,732156,0,732156
510,342,85,896270,89627,806643
511,343,72,368254,73651,294603
512,343,57,922013,184403,737610
513,344,33,737686,110653,627033
514,345,47,226500,0,226500
515,345,90,398303,39830,358473
516,346,65,950505,190101,760404
517,346,53,820943,123141,697802
518,346,23,634305,126861,507444
519,347,89,279537,13977,265560
520,348,38,914051,137108,776943
521,349,11,200350,0,200350
522,350,35,586266,29313,556953
523,351,55,683200,136640,546560
524,352,99,398614,79723,318891
525,353,4,798907,39945,758962
526,353,1,256100,12805,243295
527,354,1,256100,0,256100
528,354,69,359892,35989,323903
529,355,51,493814,24691,469123
530,356,100,675789,33789,642000
531,356,76,252436,50487,201949
532,357,17,939423,0,939423
533,358,97,979782,0,979782
534,359,10,926002,185200,740802
535,360,32,654698,0,654698
536,360,47,226500,45300,181200
537,361,59,605860,0,605860
538,362,46,693176,138635,554541
539,362,72,368254,0,368254
540,363,47,226500,22650,203850
541,363,50,729367,72937,656430
542,364,82,316592,63318,253274
543,364,90,398303,39830,358473
544,364,15,902160,0,902160
545,365,9,455685,22784,432901
546,365,52,587764,88165,499599
547,365,2,420981,0,420981
548,366,41,673087,100963,572124
549,367,19,804753,160951,643802
550,367,21,323151,16158,306993
551,368,53,820943,123141,697802
552,369,39,281587,28159,253428
553,369,13,463695,92739,370956
554,369,95,149157,0,149157
555,370,98,402922,80584,322338
556,371,45,425902,42590,383312
557,372,30,731284,73128,658156
558,373,36,428476,42848,385628
559,373,16,620111,0,620111
560,374,25,702215,0,702215
561,375,48,642399,128480,513919
562,375,70,164588,8229,156359
563,376,54,589480,88422,501058
564,376,48,642399,64240,578159
565,377,25,702215,70222,631993
566,377,46,693176,34659,658517
567,378,18,381216,0,381216
568,378,92,776090,0,776090
569,379,20,869016,86902,782114
570,379,42,857814,128672,729142
571,379,11,200350,20035,180315
572,380,46,693176,103976,589200
573,380,53,820943,0,820943
574,381,31,104484,15673,88811
575,382,47,226500,45300,181200
576,383,51,493814,0,493814
577,384,14,857700,85770,771930
578,385,48,642399,0,642399
579,386,53,820943,0,820943
580,387,25,702215,35111,667104
581,388,96,438412,87682,350730
582,389,42,857814,0,857814
583,390,10,926002,0,926002
584,391,89,279537,27954,251583
585,391,70,164588,0,164588
586,391,39,281587,42238,239349
587,392,16,620111,93017,527094
588,392,39,281587,0,281587
589,393,53,820943,164189,656754
590,394,96,438412,65762,372650
591,395,62,905813,90581,815232
592,395,26,385971,19299,366672
593,396,100,675789,135158,540631
594,397,53,820943,41047,779896
595,398,27,514662,102932,411730
596,399,95,149157,0,149157
597,400,76,252436,37865,214571
598,401,9,455685,0,455685
599,402,30,731284,73128,658156
600,403,11,200350,0,200350
601,404,13,463695,69554,394141
602,405,10,926002,92600,833402
603,405,22,170261,0,170261
604,406,99,398614,0,398614
605,407,68,654889,0,654889
606,408,23,634305,126861,507444
607,409,41,673087,0,673087
608,410,49,292071,0,292071
609,411,96,438412,0,438412
610,412,47,226500,11325,215175
611,413,29,341390,51208,290182
612,414,64,735783,147157,588626
613,414,95,149157,7458,141699
614,415,51,493814,49381,444433
615,415,94,708466,35423,673043
616,416,79,686677,0,686677
617,416,10,926002,92600,833402
618,417,39,281587,42238,239349
619,418,28,144785,21718,123067
620,419,63,825937,0,825937
621,420,99,398614,19931,378683
622,420,39,281587,14079,267508
623,421,5,269564,13478,256086
624,422,4,798907,159781,639126
625,422,43,763211,152642,610569
626,423,96,438412,21921,416491
627,424,96,438412,87682,350730
628,425,31,104484,10448,94036
629,426,36,428476,85695,342781
630,426,65,950505,0,950505
631,426,82,316592,47489,269103
632,427,53,820943,82094,738849
633,427,70,164588,0,164588
634,427,68,654889,98233,556656
635,428,53,820943,123141,697802
636,428,27,514662,51466,463196
637,429,29,341390,0,341390
638,430,78,351139,0,351139
639,430,91,601955,90293,511662
640,431,43,763211,152642,610569
641,431,41,673087,134617,538470
642,432,13,463695,0,463695
643,433,80,728935,72894,656041
644,434,59,605860,30293,575567
645,435,6,406435,0,406435
646,435,30,731284,0,731284
647,436,62,905813,135872,769941
648,436,67,554889,83233,471656
649,437,32,654698,98205,556493
650,437,67,554889,83233,471656
651,438,95,149157,14916,134241
652,439,46,693176,103976,589200
653,439,89,279537,41931,237606
654,440,91,601955,30098,571857
655,440,61,151169,15117,136052
656,441,25,702215,0,702215
657,442,54,589480,29474,560006
658,443,88,654347,130869,523478
659,444,66,454889,22744,432145
660,445,3,732156,146431,585725
661,446,85,896270,0,896270
662,446,58,192637,38527,154110
663,446,45,425902,63885,362017
664,447,54,589480,29474,560006
665,448,40,140454,0,140454
666,448,8,874637,87464,787173
667,449,96,438412,87682,350730
668,450,72,368254,36825,331429
669,450,50,729367,72937,656430
670,451,34,327720,49158,278562
671,452,87,434054,0,434054
672,452,92,776090,155218,620872
673,453,16,620111,0,620111
674,453,51,493814,0,493814
675,453,28,144785,14478,130307
676,454,51,493814,49381,444433
677,454,96,438412,65762,372650
678,455,27,514662,77199,437463
679,456,84,150772,7539,143233
680,457,77,779556,77956,701600
681,458,37,604367,120873,483494
682,459,73,868669,43433,825236
683,459,53,820943,41047,779896
684,459,71,510460,102092,408368
685,460,56,765100,0,765100
686,460,10,926002,185200,740802
687,461,16,620111,124022,496089
688,462,66,454889,90978,363911
689,462,4,798907,159781,639126
690,462,9,455685,45568,410117
691,463,50,729367,36468,692899
692,464,62,905813,90581,815232
693,464,7,314151,62830,251321
694,464,44,522577,104515,418062
695,465,57,922013,184403,737610
696,466,52,587764,88165,499599
697,467,33,737686,110653,627033
698,468,14,857700,171540,686160
699,468,53,820943,41047,779896
700,469,6,406435,20322,386113
701,469,85,896270,44814,851456
702,469,52,587764,29388,558376
703,470,91,601955,0,601955
704,471,23,634305,126861,507444
705,471,80,728935,109340,619595
706,472,75,620666,31033,589633
707,473,29,341390,68278,273112
708,474,42,857814,85781,772033
709,475,99,398614,79723,318891
710,476,37,604367,30218,574149
711,477,90,398303,79661,318642
712,478,69,359892,35989,323903
713,479,92,776090,155218,620872
714,480,74,844993,0,844993
715,481,43,763211,152642,610569
716,481,7,314151,0,314151
717,482,73,868669,86867,781802
718,482,3,732156,36608,695548
719,482,87,434054,65108,368946
720,483,54,589480,88422,501058
721,483,98,402922,40292,362630
722,483,35,586266,117253,469013
723,484,40,140454,28091,112363
724,484,33,737686,73769,663917
725,485,97,979782,146967,832815
726,486,28,144785,28957,115828
727,487,81,924381,92438,831943
728,487,59,605860,30293,575567
729,488,9,455685,45568,410117
730,489,41,673087,33654,639433
731,489,26,385971,0,385971
732,489,2,420981,0,420981
733,490,34,327720,49158,278562
734,490,4,798907,39945,758962
735,490,25,702215,35111,667104
736,491,54,589480,58948,530532
737,492,75,620666,62067,558599
738,493,93,186842,28026,158816
739,494,25,702215,105332,596883
740,495,39,281587,14079,267508
741,496,53,820943,0,820943
742,497,88,654347,130869,523478
743,497,3,732156,0,732156
744,497,81,924381,92438,831943
745,498,20,869016,0,869016
746,498,19,804753,160951,643802
747,499,40,140454,28091,112363
748,500,38,914051,0,914051
749,501,67,554889,55489,499400
750,502,16,620111,93017,527094
751,503,34,327720,49158,278562
752,504,61,151169,7558,143611
753,504,89,279537,27954,251583
754,504,72,368254,0,368254
755,505,100,675789,101368,574421
756,505,72,368254,55238,313016
757,506,83,628744,94312,534432
758,507,69,359892,71978,287914
759,508,27,514662,102932,411730
760,508,3,732156,73216,658940
761,509,28,144785,0,144785
762,510,17,939423,140913,798510
763,511,94,708466,106270,602196
764,511,55,683200,102480,580720
765,512,79,686677,0,686677
766,513,22,170261,34052,136209
767,513,6,406435,20322,386113
768,514,100,675789,135158,540631
769,515,84,150772,22616,128156
770,516,31,104484,10448,94036
771,516,94,708466,35423,673043
772,517,38,914051,137108,776943
773,518,89,279537,0,279537
774,518,43,763211,0,763211
775,518,69,359892,0,359892
776,519,13,463695,69554,394141
777,519,17,939423,187885,751538
778,519,90,398303,39830,358473
779,520,94,708466,0,708466
780,521,73,868669,130300,738369
781,522,7,314151,15708,298443
782,523,19,804753,0,804753
783,524,53,820943,123141,697802
784,525,18,381216,57182,324034
785,525,37,604367,120873,483494
786,525,13,463695,0,463695
787,526,68,654889,65489,589400
788,527,62,905813,90581,815232
789,528,53,820943,123141,697802
790,529,76,252436,50487,201949
791,530,8,874637,87464,787173
792,531,29,341390,0,341390
793,532,47,226500,0,226500
794,532,28,144785,7239,137546
795,533,92,776090,77609,698481
796,534,61,151169,0,151169
797,535,60,970703,97070,873633
798,535,66,454889,45489,409400
799,536,29,341390,0,341390
800,536,70,164588,0,164588
801,536,93,186842,28026,158816
802,537,38,914051,137108,776943
803,538,24,768119,153624,614495
804,539,91,601955,0,601955
805,540,45,425902,0,425902
806,541,35,586266,58627,527639
807,541,11,200350,30052,170298
808,542,54,589480,29474,560006
809,543,40,140454,28091,112363
810,543,1,256100,38415,217685
811,544,91,601955,120391,481564
812,545,1,256100,38415,217685
813,545,66,454889,22744,432145
814,545,50,729367,145873,583494
815,546,91,601955,30098,571857
816,546,11,200350,40070,160280
817,547,13,463695,46370,417325
818,547,57,922013,92201,829812
819,548,29,341390,51208,290182
820,548,99,398614,39861,358753
821,549,64,735783,0,735783
822,550,66,454889,22744,432145
823,550,27,514662,102932,411730
824,551,2,420981,84196,336785
825,551,70,164588,8229,156359
826,552,5,269564,53913,215651
827,553,98,402922,40292,362630
828,554,89,279537,55907,223630
829,555,47,226500,0,226500
830,556,88,654347,32717,621630
831,556,31,104484,0,104484
832,557,9,455685,45568,410117
833,558,71,510460,76569,433891
834,559,52,587764,29388,558376
835,559,87,434054,21703,412351
836,560,69,359892,71978,287914
837,561,80,728935,109340,619595
838,561,55,683200,0,683200
839,562,63,825937,41297,784640
840,563,31,104484,5224,99260
841,564,78,351139,52671,298468
842,565,41,673087,67309,605778
843,566,33,737686,36884,700802
844,567,94,708466,141693,566773
845,568,28,144785,0,144785
846,568,29,341390,68278,273112
847,569,56,765100,0,765100
848,570,16,620111,0,620111
849,571,55,683200,68320,614880
850,572,71,510460,0,510460
851,573,17,939423,93942,845481
852,573,90,398303,0,398303
853,573,76,252436,50487,201949
854,574,66,454889,45489,409400
855,574,18,381216,38122,343094
856,574,75,620666,93100,527566
857,575,6,406435,20322,386113
858,576,66,454889,90978,363911
859,577,9,455685,45568,410117
860,577,100,675789,101368,574421
861,578,40,140454,7023,133431
862,578,16,620111,62011,558100
863,579,61,151169,7558,143611
864,580,29,341390,17070,324320
865,581,94,708466,106270,602196
866,582,53,820943,82094,738849
867,582,77,779556,77956,701600
868,583,5,269564,13478,256086
869,584,61,151169,7558,143611
870,585,95,149157,14916,134241
871,586,30,731284,0,731284
872,587,71,510460,25523,484937
873,587,45,425902,21295,404607
874,588,46,693176,34659,658517
875,589,71,510460,25523,484937
876,590,85,896270,89627,806643
877,591,83,628744,62874,565870
878,592,45,425902,42590,383312
879,592,41,673087,134617,538470
880,593,35,586266,58627,527639
881,593,77,779556,0,779556
882,593,40,140454,14045,126409
883,594,56,765100,76510,688590
884,594,16,620111,31006,589105
885,595,14,857700,42885,814815
886,596,46,693176,0,693176
887,596,43,763211,76321,686890
888,597,61,151169,22675,128494
889,597,86,684158,68416,615742
890,598,58,192637,28896,163741
891,599,47,226500,0,226500
892,600,82,316592,31659,284933
893,601,6,406435,60965,345470
894,602,81,924381,92438,831943
895,603,62,905813,135872,769941
896,603,68,654889,65489,589400
897,604,57,922013,92201,829812
898,605,18,381216,57182,324034
899,605,36,428476,64271,364205
900,606,69,359892,17995,341897
901,607,53,820943,0,820943
902,607,65,950505,95050,855455
903,608,47,226500,11325,215175
904,609,88,654347,130869,523478
905,610,4,798907,119836,679071
906,611,35,586266,117253,469013
907,612,12,295990,14800,281190
908,613,95,149157,14916,134241
909,614,23,634305,0,634305
910,615,61,151169,30234,120935
911,616,37,604367,120873,483494
912,617,96,438412,21921,416491
913,618,19,804753,0,804753
914,618,49,292071,43811,248260
915,619,68,654889,0,654889
916,620,21,323151,48473,274678
917,621,46,693176,103976,589200
918,621,14,857700,0,857700
919,622,14,857700,128655,729045
920,622,69,359892,35989,323903
921,623,73,868669,173734,694935
922,624,34,327720,16386,311334
923,625,40,140454,14045,126409
924,625,89,279537,41931,237606
925,626,51,493814,49381,444433
926,627,8,874637,131196,743441
927,627,37,604367,120873,483494
928,628,62,905813,90581,815232
929,629,69,359892,35989,323903
930,630,7,314151,47123,267028
931,631,100,675789,33789,642000
932,632,58,192637,28896,163741
933,632,14,857700,171540,686160
934,632,64,735783,73578,662205
935,633,78,351139,35114,316025
936,633,42,857814,0,857814
937,633,59,605860,90879,514981
938,634,75,620666,93100,527566
939,635,73,868669,0,868669
940,635,12,295990,14800,281190
941,636,83,628744,31437,597307
942,637,52,587764,117553,470211
943,637,18,381216,19061,362155
944,637,56,765100,114765,650335
945,638,91,601955,120391,481564
946,639,79,686677,0,686677
947,639,82,316592,15830,300762
948,640,16,620111,31006,589105
949,640,64,735783,36789,698994
950,640,30,731284,109693,621591
951,641,85,896270,89627,806643
952,642,72,368254,0,368254
953,643,76,252436,25244,227192
954,644,16,620111,0,620111
955,644,66,454889,45489,409400
956,645,54,589480,29474,560006
957,646,47,226500,22650,203850
958,646,73,868669,0,868669
959,647,48,642399,0,642399
960,648,13,463695,0,463695
961,649,3,732156,36608,695548
962,650,93,186842,37368,149474
963,651,6,406435,40644,365791
964,652,1,256100,51220,204880
965,653,31,104484,20897,83587
966,653,47,226500,22650,203850
967,654,77,779556,77956,701600
968,654,58,192637,38527,154110
969,655,32,654698,65470,589228
970,655,50,729367,145873,583494
971,656,43,763211,38161,725050
972,656,83,628744,62874,565870
973,657,44,522577,78387,444190
974,658,53,820943,123141,697802
975,659,25,702215,35111,667104
976,659,59,605860,60586,545274
977,660,44,522577,26129,496448
978,660,71,510460,25523,484937
979,661,67,554889,83233,471656
980,662,70,164588,8229,156359
981,662,68,654889,0,654889
982,662,36,428476,64271,364205
983,663,62,905813,45291,860522
984,663,46,693176,138635,554541
985,664,55,683200,136640,546560
986,665,58,192637,28896,163741
987,666,80,728935,72894,656041
988,666,9,455685,45568,410117
989,667,77,779556,38978,740578
990,667,48,642399,128480,513919
991,668,20,869016,173803,695213
992,668,66,454889,68233,386656
993,669,15,902160,180432,721728
994,670,73,868669,0,868669
995,670,81,924381,46219,878162
996,671,13,463695,92739,370956
997,672,60,970703,97070,873633
998,673,97,979782,97978,881804
999,673,39,281587,0,281587
1000,673,59,605860,121172,484688
1001,674,51,493814,98763,395051
1002,675,88,654347,98152,556195
1003,675,10,926002,185200,740802
1004,676,40,140454,28091,112363
1005,677,19,804753,160951,643802
1006,677,89,279537,13977,265560
1007,678,63,825937,41297,784640
1008,678,31,104484,0,104484
1009,678,57,922013,92201,829812
1010,679,86,684158,102624,581534
1011,680,15,902160,90216,811944
1012,681,19,804753,40238,764515
1013,682,40,140454,28091,112363
1014,682,77,779556,77956,701600
1015,682,6,406435,60965,345470
1016,683,2,420981,21049,399932
1017,684,22,170261,0,170261
1018,685,97,979782,0,979782
1019,685,8,874637,174927,699710
1020,686,30,731284,36564,694720
1021,686,3,732156,146431,585725
1022,687,69,359892,35989,323903
1023,687,96,438412,0,438412
1024,687,76,252436,0,252436
1025,688,77,779556,155911,623645
1026,689,40,140454,14045,126409
1027,690,26,385971,77194,308777
1028,690,87,434054,21703,412351
1029,691,15,902160,135324,766836
1030,691,84,150772,7539,143233
1031,692,16,620111,124022,496089
1032,693,78,351139,35114,316025
1033,694,25,702215,35111,667104
1034,695,10,926002,185200,740802
1035,696,38,914051,91405,822646
1036,697,91,601955,30098,571857
1037,697,69,359892,71978,287914
1038,697,71,510460,51046,459414
1039,698,3,732156,36608,695548
1040,698,89,279537,13977,265560
1041,699,61,151169,30234,120935
1042,700,51,493814,74072,419742
1043,700,78,351139,70228,280911
1044,701,59,605860,0,605860
1045,701,33,737686,73769,663917
1046,702,41,673087,0,673087
1047,702,78,351139,52671,298468
1048,703,39,281587,28159,253428
1049,704,67,554889,0,554889
1050,705,46,693176,69318,623858
1051,706,93,186842,28026,158816
1052,707,18,381216,19061,362155
1053,707,92,776090,38804,737286
1054,708,85,896270,44814,851456
1055,708,60,970703,194141,776562
1056,708,28,144785,0,144785
1057,709,16,620111,0,620111
1058,709,11,200350,10018,190332
1059,710,95,149157,0,149157
1060,710,77,779556,38978,740578
1061,710,46,693176,103976,589200
1062,711,73,868669,43433,825236
1063,711,23,634305,95146,539159
1064,712,10,926002,138900,787102
1065,713,31,104484,5224,99260
1066,713,62,905813,90581,815232
1067,714,28,144785,21718,123067
1068,715,60,970703,0,970703
1069,716,42,857814,85781,772033
1070,717,81,924381,138657,785724
1071,718,85,896270,0,896270
1072,718,92,776090,155218,620872
1073,719,85,896270,134440,761830
1074,720,50,729367,72937,656430
1075,720,72,368254,36825,331429
1076,721,98,402922,80584,322338
1077,721,82,316592,31659,284933
1078,722,100,675789,67579,608210
1079,722,86,684158,0,684158
1080,723,26,385971,0,385971
1081,723,28,144785,14478,130307
1082,724,61,151169,0,151169
1083,725,12,295990,44398,251592
1084,726,61,151169,15117,136052
1085,726,1,256100,12805,243295
1086,727,58,192637,19264,173373
1087,727,19,804753,40238,764515
1088,728,61,151169,7558,143611
1089,729,33,737686,147537,590149
1090,729,55,683200,136640,546560
1091,730,42,857814,171563,686251
1092,731,15,902160,180432,721728
1093,732,27,514662,25733,488929
1094,732,59,605860,90879,514981
1095,733,20,869016,130352,738664
1096,734,93,186842,18684,168158
1097,735,85,896270,44814,851456
1098,736,47,226500,33975,192525
1099,736,10,926002,92600,833402
1100,736,30,731284,73128,658156
1101,737,49,292071,14604,277467
1102,737,44,522577,0,522577
1103,737,77,779556,0,779556
1104,738,5,269564,53913,215651
1105,738,52,587764,88165,499599
1106,738,82,316592,63318,253274
1107,739,77,779556,77956,701600
1108,740,64,735783,147157,588626
1109,741,28,144785,14478,130307
1110,741,40,140454,0,140454
1111,741,100,675789,135158,540631
1112,742,23,634305,31715,602590
1113,743,81,924381,0,924381
1114,743,66,454889,22744,432145
1115,744,64,735783,147157,588626
1116,744,20,869016,43451,825565
1117,745,83,628744,125749,502995
1118,746,87,434054,21703,412351
1119,746,63,825937,82594,743343
1120,747,73,868669,130300,738369
1121,748,72,368254,18413,349841
1122,748,56,765100,114765,650335
1123,748,61,151169,22675,128494
1124,749,2,420981,84196,336785
1125,749,87,434054,65108,368946
1126,750,27,514662,25733,488929
1127,751,49,292071,0,292071
1128,752,83,628744,125749,502995
1129,753,89,279537,27954,251583
1130,754,61,151169,15117,136052
1131,755,78,351139,17557,333582
1132,755,89,279537,27954,251583
1133,756,42,857814,42891,814923
1134,757,2,420981,21049,399932
1135,758,56,765100,0,765100
1136,759,17,939423,187885,751538
1137,759,4,798907,39945,758962
1138,760,8,874637,43732,830905
1139,760,30,731284,109693,621591
1140,761,16,620111,124022,496089
1141,761,79,686677,34334,652343
1142,761,42,857814,42891,814923
1143,762,5,269564,13478,256086
1144,763,7,314151,62830,251321
1145,764,87,434054,21703,412351
1146,765,54,589480,0,589480
1147,765,18,381216,19061,362155
1148,766,9,455685,45568,410117
1149,766,23,634305,126861,507444
1150,767,25,702215,70222,631993
1151,767,5,269564,53913,215651
1152,768,55,683200,68320,614880
1153,768,38,914051,182810,731241
1154,769,98,402922,60438,342484
1155,770,47,226500,22650,203850
1156,771,14,857700,42885,814815
1157,771,57,922013,0,922013
1158,772,35,586266,87940,498326
1159,773,29,341390,68278,273112
1160,774,99,398614,39861,358753
1161,775,82,316592,15830,300762
1162,776,83,628744,0,628744
1163,777,50,729367,109405,619962
1164,778,41,673087,67309,605778
1165,779,46,693176,103976,589200
1166,779,96,438412,65762,372650
1167,780,7,314151,0,314151
1168,780,15,902160,0,902160
1169,781,51,493814,49381,444433
1170,781,53,820943,123141,697802
1171,782,8,874637,174927,699710
1172,782,88,654347,32717,621630
1173,783,85,896270,134440,761830
1174,783,37,604367,90655,513712
1175,783,45,425902,0,425902
1176,784,77,779556,0,779556
1177,785,8,874637,131196,743441
1178,786,93,186842,18684,168158
1179,787,54,589480,29474,560006
1180,788,62,905813,0,905813
1181,789,20,869016,43451,825565
1182,790,43,763211,76321,686890
1183,790,80,728935,145787,583148
1184,791,94,708466,0,708466
1185,792,47,226500,33975,192525
1186,792,11,200350,10018,190332
1187,793,1,256100,38415,217685
1188,794,85,896270,44814,851456
1189,795,16,620111,124022,496089
1190,796,36,428476,42848,385628
1191,797,38,914051,91405,822646
1192,798,75,620666,93100,527566
1193,799,17,939423,187885,751538
1194,800,27,514662,77199,437463
1195,801,53,820943,0,820943
1196,801,56,765100,76510,688590
1197,801,83,628744,94312,534432
1198,802,96,438412,43841,394571
1199,803,83,628744,94312,534432
1200,803,24,768119,153624,614495
1201,803,58,192637,19264,173373
1202,804,86,684158,68416,615742
1203,805,29,341390,34139,307251
1204,805,15,902160,90216,811944
1205,806,74,844993,168999,675994
1206,807,71,510460,25523,484937
1207,808,26,385971,0,385971
1208,809,54,589480,0,589480
1209,810,6,406435,20322,386113
1210,810,78,351139,52671,298468
1211,810,70,164588,8229,156359
1212,811,95,149157,29831,119326
1213,811,44,522577,0,522577
1214,811,46,693176,103976,589200
1215,812,55,683200,102480,580720
1216,813,83,628744,94312,534432
1217,814,17,939423,140913,798510
1218,815,84,150772,30154,120618
1219,816,40,140454,28091,112363
1220,817,7,314151,62830,251321
1221,817,34,327720,65544,262176
1222,818,75,620666,31033,589633
1223,818,97,979782,195956,783826
1224,819,26,385971,38597,347374
1225,820,66,454889,90978,363911
1226,821,72,368254,55238,313016
1227,822,51,493814,98763,395051
1228,823,44,522577,104515,418062
1229,823,41,673087,134617,538470
1230,823,97,979782,146967,832815
1231,824,44,522577,78387,444190
1232,825,82,316592,31659,284933
1233,826,46,693176,103976,589200
1234,826,20,869016,43451,825565
1235,826,47,226500,22650,203850
1236,827,76,252436,37865,214571
1237,827,88,654347,130869,523478
1238,828,91,601955,120391,481564
1239,829,29,341390,0,341390
1240,830,63,825937,82594,743343
1241,831,86,684158,0,684158
1242,832,72,368254,55238,313016
1243,833,72,368254,55238,313016
1244,833,26,385971,77194,308777
1245,833,23,634305,31715,602590
1246,834,51,493814,98763,395051
1247,835,70,164588,32918,131670
1248,835,51,493814,98763,395051
1249,836,98,402922,40292,362630
1250,836,97,979782,97978,881804
1251,837,46,693176,103976,589200
1252,838,16,620111,124022,496089
1253,839,78,351139,17557,333582
1254,840,100,675789,33789,642000
1255,841,70,164588,16459,148129
1256,841,47,226500,22650,203850
1257,842,17,939423,93942,845481
1258,843,58,192637,38527,154110
1259,843,7,314151,47123,267028
1260,844,50,729367,109405,619962
1261,845,35,586266,117253,469013
1262,846,84,150772,22616,128156
1263,847,34,327720,49158,278562
1264,848,12,295990,29599,266391
1265,849,26,385971,19299,366672
1266,850,91,601955,0,601955
1267,850,11,200350,30052,170298
1268,851,9,455685,22784,432901
1269,851,15,902160,0,902160
1270,852,44,522577,104515,418062
1271,852,40,140454,0,140454
1272,853,13,463695,23185,440510
1273,853,82,316592,15830,300762
1274,853,64,735783,110367,625416
1275,854,26,385971,19299,366672
1276,855,53,820943,41047,779896
1277,856,55,683200,102480,580720
1278,857,63,825937,82594,743343
1279,858,98,402922,40292,362630
1280,859,69,359892,35989,323903
1281,859,57,922013,92201,829812
1282,859,78,351139,17557,333582
1283,860,55,683200,0,683200
1284,860,91,601955,60196,541759
1285,861,56,765100,0,765100
1286,862,61,151169,0,151169
1287,862,96,438412,65762,372650
1288,863,63,825937,123891,702046
1289,863,73,868669,0,868669
1290,864,92,776090,155218,620872
1291,865,28,144785,14478,130307
1292,866,6,406435,20322,386113
1293,866,19,804753,40238,764515
1294,867,61,151169,0,151169
1295,868,6,406435,60965,345470
1296,869,48,642399,64240,578159
1297,869,20,869016,86902,782114
1298,870,8,874637,87464,787173
1299,871,54,589480,29474,560006
1300,871,41,673087,0,673087
1301,872,34,327720,0,327720
1302,872,46,693176,69318,623858
1303,873,100,675789,135158,540631
1304,874,96,438412,21921,416491
1305,874,2,420981,42098,378883
1306,875,44,522577,104515,418062
1307,876,30,731284,73128,658156
1308,877,65,950505,0,950505
1309,878,58,192637,9632,183005
1310,879,43,763211,38161,725050
1311,880,47,226500,11325,215175
1312,881,5,269564,40435,229129
1313,882,7,314151,47123,267028
1314,882,37,604367,0,604367
1315,883,24,768119,115218,652901
1316,883,79,686677,137335,549342
1317,884,50,729367,72937,656430
1318,884,9,455685,22784,432901
1319,885,63,825937,0,825937
1320,886,95,149157,14916,134241
1321,886,96,438412,87682,350730
1322,887,10,926002,92600,833402
1323,888,29,341390,0,341390
1324,888,31,104484,15673,88811
1325,888,43,763211,152642,610569
1326,889,84,150772,15077,135695
1327,889,10,926002,46300,879702
1328,890,75,620666,62067,558599
1329,891,8,874637,0,874637
1330,891,71,510460,25523,484937
1331,892,81,924381,138657,785724
1332,892,89,279537,0,279537
1333,893,82,316592,31659,284933
1334,894,75,620666,31033,589633
1335,894,64,735783,147157,588626
1336,895,62,905813,135872,769941
1337,896,90,398303,39830,358473
1338,896,12,295990,59198,236792
1339,897,5,269564,40435,229129
1340,897,41,673087,33654,639433
1341,897,87,434054,0,434054
1342,898,36,428476,64271,364205
1343,899,47,226500,11325,215175
1344,899,39,281587,14079,267508
1345,900,41,673087,134617,538470
1346,901,51,493814,74072,419742
1347,902,61,151169,15117,136052
1348,903,43,763211,76321,686890
1349,903,93,186842,18684,168158
1350,904,83,628744,62874,565870
1351,905,22,170261,17026,153235
1352,906,71,510460,102092,408368
1353,907,64,735783,110367,625416
1354,908,18,381216,38122,343094
1355,908,29,341390,34139,307251
1356,909,80,728935,145787,583148
1357,910,57,922013,0,922013
1358,911,60,970703,145605,825098
1359,912,16,620111,0,620111
1360,913,27,514662,0,514662
1361,914,46,693176,138635,554541
1362,914,30,731284,146257,585027
1363,915,2,420981,0,420981
1364,915,76,252436,50487,201949
1365,916,92,776090,38804,737286
1366,917,49,292071,58414,233657
1367,918,75,620666,62067,558599
1368,919,12,295990,14800,281190
1369,919,35,586266,87940,498326
1370,920,36,428476,42848,385628
1371,920,33,737686,110653,627033
1372,921,95,149157,7458,141699
1373,921,73,868669,86867,781802
1374,922,15,902160,135324,766836
1375,922,95,149157,22374,126783
1376,923,51,493814,74072,419742
1377,923,10,926002,46300,879702
1378,924,47,226500,33975,192525
1379,924,15,902160,90216,811944
1380,925,87,434054,21703,412351
1381,926,6,406435,81287,325148
1382,927,56,765100,76510,688590
1383,927,22,170261,34052,136209
1384,928,3,732156,36608,695548
1385,929,49,292071,0,292071
1386,930,67,554889,55489,499400
1387,930,41,673087,67309,605778
1388,931,22,170261,17026,153235
1389,932,81,924381,46219,878162
1390,932,45,425902,85180,340722
1391,932,19,804753,120713,684040
1392,933,64,735783,36789,698994
1393,933,9,455685,45568,410117
1394,934,63,825937,0,825937
1395,935,25,702215,70222,631993
1396,936,66,454889,22744,432145
1397,937,98,402922,60438,342484
1398,938,94,708466,35423,673043
1399,938,41,673087,67309,605778
1400,938,51,493814,49381,444433
1401,939,78,351139,70228,280911
1402,940,69,359892,17995,341897
1403,940,31,104484,0,104484
1404,941,82,316592,63318,253274
1405,941,17,939423,140913,798510
1406,941,77,779556,116933,662623
1407,942,55,683200,102480,580720
1408,942,37,604367,60437,543930
1409,943,91,601955,60196,541759
1410,943,19,804753,0,804753
1411,943,31,104484,0,104484
1412,944,19,804753,160951,643802
1413,944,81,924381,46219,878162
1414,945,85,896270,0,896270
1415,946,25,702215,140443,561772
1416,947,91,601955,0,601955
1417,947,64,735783,110367,625416
1418,948,47,226500,33975,192525
1419,949,88,654347,130869,523478
1420,950,47,226500,11325,215175
1421,951,51,493814,0,493814
1422,952,2,420981,21049,399932
1423,953,47,226500,22650,203850
1424,953,63,825937,82594,743343
1425,954,54,589480,29474,560006
1426,955,36,428476,42848,385628
1427,955,20,869016,0,869016
1428,955,68,654889,32744,622145
1429,956,47,226500,45300,181200
1430,957,39,281587,56317,225270
1431,958,62,905813,135872,769941
1432,958,13,463695,23185,440510
1433,959,54,589480,0,589480
1434,960,32,654698,65470,589228
1435,960,93,186842,9342,177500
1436,961,77,779556,38978,740578
1437,962,3,732156,109823,622333
1438,963,56,765100,76510,688590
1439,964,22,170261,25539,144722
1440,964,20,869016,43451,825565
1441,965,78,351139,17557,333582
1442,966,75,620666,0,620666
1443,967,91,601955,30098,571857
1444,967,68,654889,65489,589400
1445,967,83,628744,94312,534432
1446,968,18,381216,0,381216
1447,969,25,702215,35111,667104
1448,969,91,601955,120391,481564
1449,970,85,896270,179254,717016
1450,971,10,926002,138900,787102
1451,972,100,675789,0,675789
1452,973,16,620111,93017,527094
1453,974,4,798907,39945,758962
1454,974,98,402922,20146,382776
1455,974,53,820943,41047,779896
1456,975,94,708466,141693,566773
1457,976,100,675789,67579,608210
1458,976,19,804753,160951,643802
1459,976,17,939423,93942,845481
1460,977,28,144785,28957,115828
1461,978,62,905813,0,905813
1462,978,3,732156,73216,658940
1463,979,59,605860,0,605860
1464,980,13,463695,0,463695
1465,980,31,104484,10448,94036
1466,981,16,620111,0,620111
1467,982,99,398614,19931,378683
1468,983,52,587764,117553,470211
1469,983,97,979782,97978,881804
1470,984,64,735783,36789,698994
1471,984,92,776090,38804,737286
1472,985,13,463695,69554,394141
1473,986,58,192637,0,192637
1474,986,60,970703,48535,922168
1475,987,91,601955,0,601955
1476,987,58,192637,0,192637
1477,988,21,323151,0,323151
1478,988,47,226500,45300,181200
1479,988,60,970703,97070,873633
1480,989,26,385971,57896,328075
1481,989,62,905813,0,905813
1482,990,10,926002,185200,740802
1483,990,31,104484,20897,83587
1484,991,33,737686,73769,663917
1485,992,12,295990,29599,266391
1486,993,21,323151,0,323151
1487,994,94,708466,0,708466
1488,995,25,702215,0,702215
1489,996,29,341390,0,341390
1490,997,85,896270,179254,717016
1491,997,74,844993,126749,718244
1492,998,45,425902,63885,362017
1493,999,12,295990,14800,281190
1494,1000,99,398614,0,398614
1495,1000,78,351139,0,351139
